111111111111111111
10C1010000000000C1
10000100000000C001
10000100000000C001
10000000000000C001
100001000A0000C001
10000100000000C001
1P0C01E00000000001
111111111111111111