111111111111111
1AE0C0CCC00C0P1
111111111111111
