1111111111111
10E1000000001
10C0011011001
10P0110001001
1111111111111
